...###
..##.#.##
.##..###.
##..@....
#..#@#.#.
########.
..#..#...
.##.##.#.
.#......#
.#.....##
.#######